//Shake Down

UseTerrain=TRUE
MapCoordinates=2052,770

MapNavigationData=campaign/images/maps/south_china_sea_navmap
MapElevationData=campaign/images/maps/south_china_sea_bathymetry
WorldObjectsData=campaign/maps/south_china_sea_world_objects
VesselsAndTraffic=campaign/maps/south_china_sea_traffic


//Environment
Date=11 DEC 1998
Hemisphere=North
Time=0700
UsePresetEnvironment=FALSE
Weather=Clear
SeaState=LightBreeze
DuctStrength=Moderate
LayerStrength=Moderate

//Enemy Ships
NumberOfEnemyUnits=1-2
CombatBehaviour=OFFENSIVE
EnemyUnitMissionCritical=FALSE
EnemyShipClasses=plan_ssn_han,plan_ssk_song
//Ship positions and headings, otherwise build into a formation

//Enemy Aircraft
NumberOfHelicopters=0
HelicopterType=wp_helix
NumberOfAircraft=0
AircraftType=wp_il-38_may

PlayerVessels=roc_73_ss_guppy_tench
CommanderName=COMSUBPAC
CommanderFleetName=CINCPACFLT